1111111111111
10010000000C1
1000011111001
110011E000001
10010000000C1
1000C11111001
1P00110000001
1111111111111
