1111111111111111111111111111111111
10C10000000C1EP000000000000C000001
1010010100111000101001000000010101
1010010100100111101001000111110101
1C10010100100000101001000000010101
1C10010010101010001001111110010101
1C10011110101010001001000000010101
1C10010010101010001001000000010101
1C0000000C00C000CCC111CC00000000C1
1111110000C00000C11001100000111111
101001010010000010100100000001C1C1
1010010100100000101001000111110101
1010010100100000101001000000010101
1010010010101010001001111110010101
1010010010101010001001000000010101
1010010010101010001001000000010101
110000000C00C0000CCCCCCCCCCC0000C1
1111111111111111111111111111111111
