11111
1C001
10001
1P0E1
11111
